8.ox
........
.ooo..o.
oooo.o.o
....o.o.
.ooo....
.o.ooo..
...oo.o.
.ooo...o
